ABeeZee=ABeeZee;
Abel=Abel;
Abril Fatface=Abril Fatface;
Aclonica=Aclonica;
Acme=Acme;
Actor=Actor;
Adamina=Adamina;
Advent Pro:300,400,600,700,800=Advent Pro;
Aguafina Script=Aguafina Script;
Akronim=Akronim;
Aladin=Aladin;
Aldrich=Aldrich;
Alegreya:400,700,900=Alegreya;
Alfa Slab One=Alfa Slab One;
Alice=Alice;
Alike Angular=Alike Angular;
Allan=Allan;
Allerta=Allerta;
Allerta Stencil=Allerta Stencil;
Allura=Allura;
Almendra=Almendra;
Almendra SC=Almendra SC;
Amarante=Amarante;
Amaranth:400,700=Amaranth;
Amatic SC:400,700=Amatic SC;
Amethysta=Amethysta;
Anaheim=Anaheim;
Andada=Andada;
Andika=Andika;
Angkor=Angkor;
Annie Use Your Telescope=Annie Use Your Telescope;
Anonymous Pro:400,700=Anonymous Pro;
Antic=Antic;
Antic Didone=Antic Didone;
Antic Slab=Antic Slab;
Anton=Anton;
Arapey=Arapey;
Arbutus=Arbutus;
Arbutus Slab=Arbutus Slab;
Architects Daughter=Architects Daughter;
Archivo Black=Archivo Black;
Archivo Narrow:400,700=Archivo Narrow;
Arimo:400,700=Arimo;
Arizonia=Arizonia;
Armata=Armata;
Artifika=Artifika;
Arvo=Arvo;
Asap=Asap;
Asset=Asset;
Astloch=Astloch;
Asul=Asul;
Atomic Age=Atomic Age;
Aubrey=Aubrey;
Audiowide=Audiowide;
Autour One=Autour One;
Average=Average;
Average Sans=Average Sans;
Averia Gruesa Libre=Averia Gruesa Libre;
Averia Libre=Averia Libre;
Bad Script=Bad Script;
Balthazar=Balthazar;
Bangers=Bangers;
Basic=Basic;
Battambang=Battambang;
Baumans=Baumans;
Bayon=Bayon;
Belgrano=Belgrano;
Belleza=Belleza;
BenchNine=BenchNine;
Bentham=Bentham;
Berkshire Swash=Berkshire Swash;
Bevan=Bevan;
Bigshot One=Bigshot One;
Bilbo=Bilbo;
Bilbo Swash Caps=Bilbo Swash Caps;
Bitter=Bitter;
Black Ops One=Black Ops One;
Bokor=Bokor;
Bonbon=Bonbon;
Boogaloo=Boogaloo;
Bowlby One=Bowlby One;
Bowlby One SC=Bowlby One SC;
Brawler=Brawler;
Bree Serif=Bree Serif;
Bubblegum Sans=Bubblegum Sans;
Bubbler One=Bubbler One;
Buenard=Buenard;
Butcherman=Butcherman;
Butterfly Kids=Butterfly Kids;
Cabin=Cabin;
Cabin Condensed=Cabin Condensed;
Cabin Sketch=Cabin Sketch;
Caesar Dressing=Caesar Dressing;
Cagliostro=Cagliostro;
Calligraffitti=Calligraffitti;
Cambo=Cambo;
Candal=Candal;
Cantarell=Cantarell;
Cantata One=Cantata One;
Cantora One=Cantora One;
Capriola=Capriola;
Cardo=Cardo;
Carme=Carme;
Carrois Gothic=Carrois Gothic;
Carrois Gothic SC=Carrois Gothic SC;
Carter One=Carter One;
Caudex=Caudex;
Cedarville Cursive=Cedarville Cursive;
Ceviche One=Ceviche One;
Changa One=Changa One;
Chango=Chango;
Chau Philomene One=Chau Philomene One;
Chela One=Chela One;
Chelsea Market=Chelsea Market;
Chenla=Chenla;
Cherry Cream Soda=Cherry Cream Soda;
Cherry Swash=Cherry Swash;
Chewy=Chewy;
Chicle=Chicle;
Chivo=Chivo;
Cinzel=Cinzel;
Cinzel Decorative=Cinzel Decorative;
Coda=Coda;
Codystar=Codystar;
Combo=Combo;
Comfortaa=Comfortaa;
Coming Soon=Coming Soon;
Concert One=Concert One;
Condiment=Condiment;
Content=Content;
Content: 700=Content Bold;
Contrail One=Contrail One;
Convergence=Convergence;
Cookie=Cookie;
Copse=Copse;
Corben=Corben;
Courgette=Courgette;
Cousine=Cousine;
Coustard=Coustard;
Covered By Your Grace=Covered By Your Grace;
Crafty Girls=Crafty Girls;
Creepster=Creepster;
Crete Round=Crete Round;
Crimson Text=Crimson Text;
Crushed=Crushed;
Cuprum=Cuprum;
Cutive=Cutive;
Cutive Mono=Cutive Mono;
Damion=Damion;
Dancing Script=Dancing Script;
Dangrek=Dangrek;
Dawning of a New Day=Dawning of a New Day;
Days One=Days One;
Delius=Delius;
Delius Swash Caps=Delius Swash Caps;
Delius Unicase=Delius Unicase;
Della Respira=Della Respira;
Devonshire=Devonshire;
Didact Gothic=Didact Gothic;
Diplomata=Diplomata;
Diplomata SC=Diplomata SC;
Doppio One=Doppio One;
Dorsa=Dorsa;
Dosis=Dosis;
Dr Sugiyama=Dr Sugiyama;
Droid Sans=Droid Sans;
Droid Sans Mono=Droid Sans Mono;
Droid Serif=Droid Serif;
Duru Sans=Duru Sans;
Dynalight=Dynalight;
EB Garamond=EB Garamond;
Eagle Lake=Eagle Lake;
Eater=Eater;
Economica=Economica;
Electrolize=Electrolize;
Emblema One=Emblema One;
Emilys Candy=Emilys Candy;
Engagement=Engagement;
Enriqueta=Enriqueta;
Erica One=Erica One;
Esteban=Esteban;
Euphoria Script=Euphoria Script;
Ewert=Ewert;
Exo=Exo;
Fanwood Text=Fanwood Text;
Fascinate=Fascinate;
Fascinate Inline=Fascinate Inline;
Faster One=Faster One;
Fasthand=Fasthand;
Federant=Federant;
Federo=Federo;
Felipa=Felipa;
Fenix=Fenix;
Finger Paint=Finger Paint;
Fjord One=Fjord One;
Flamenco=Flamenco;
Flavors=Flavors;
Fondamento=Fondamento;
Fontdiner Swanky=Fontdiner Swanky;
Forum=Forum;
Francois One=Francois One;
Fredericka the Great=Fredericka the Great;
Fredoka One=Fredoka One;
Freehand=Freehand;
Fresca=Fresca;
Frijole=Frijole;
Fugaz One=Fugaz One;
GFS Didot=GFS Didot;
GFS Neohellenic=GFS Neohellenic;
Galdeano=Galdeano;
Galindo=Galindo;
Gentium Basic=Gentium Basic;
Gentium Book Basic=Gentium Book Basic;
Geo=Geo;
Geostar=Geostar;
Geostar Fill=Geostar Fill;
Germania One=Germania One;
Give You Glory=Give You Glory;
Glass Antiqua=Glass Antiqua;
Glegoo=Glegoo;
Gloria Hallelujah=Gloria Hallelujah;
Goblin One=Goblin One;
Gochi Hand=Gochi Hand;
Gorditas=Gorditas;
Goudy Bookletter 1911=Goudy Bookletter 1911;
Graduate=Graduate;
Gravitas One=Gravitas One;
Great Vibes=Great Vibes;
Griffy=Griffy;
Gruppo=Gruppo;
Gudea=Gudea;
Habibi=Habibi;
Hammersmith One=Hammersmith One;
Handlee=Handlee;
Hanuman=Hanuman;
Happy Monkey=Happy Monkey;
Headland One=Headland One;
Henny Penny=Henny Penny;
Herr Von Muellerhoff=Herr Von Muellerhoff;
Holtwood One SC=Holtwood One SC;
Homemade Apple=Homemade Apple;
Homenaje=Homenaje;
IM Fell DW Pica=IM Fell DW Pica;
IM Fell DW Pica SC=IM Fell DW Pica SC;
IM Fell Double Pica=IM Fell Double Pica;
IM Fell Double Pica SC=IM Fell Double Pica SC;
IM Fell English=IM Fell English;
IM Fell English SC=IM Fell English SC;
IM Fell French Canon=IM Fell French Canon;
IM Fell French Canon SC=IM Fell French Canon SC;
IM Fell Great Primer=IM Fell Great Primer;
IM Fell Great Primer SC=IM Fell Great Primer SC;
Iceberg=Iceberg;
Iceland=Iceland;
Imprima=Imprima;
Inconsolata=Inconsolata;
Inder=Inder;
Indie Flower=Indie Flower;
Inika=Inika;
Irish Grover=Irish Grover;
Istok Web=Istok Web;
Italiana=Italiana;
Italianno=Italianno;
Jacques Francois=Jacques Francois;
Jacques Francois Shadow=Jacques Francois Shadow;
Jim Nightshade=Jim Nightshade;
Jockey One=Jockey One;
Jolly Lodger=Jolly Lodger;
Josefin Sans=Josefin Sans;
Josefin Slab=Josefin Slab;
Judson=Judson;
Julee=Julee;
Julius Sans One=Julius Sans One;
Junge=Junge;
Jura=Jura;
Just Another Hand=Just Another Hand;
Just Me Again Down Here=Just Me Again Down Here;
Kameron=Kameron;
Karla=Karla;
Kaushan Script=Kaushan Script;
Kelly Slab=Kelly Slab;
Kenia=Kenia;
Khmer=Khmer;
Kite One=Kite One;
Knewave=Knewave;
Kotta One=Kotta One;
Koulen=Koulen;
Kranky=Kranky;
Kreon=Kreon;
Kristi=Kristi;
Krona One=Krona One;
La Belle Aurore=La Belle Aurore;
Lancelot=Lancelot;
Lato=Lato;
League Script=League Script;
Leckerli One=Leckerli One;
Ledger=Ledger;
Lekton=Lekton;
Lemon=Lemon;
Life Savers=Life Savers;
Lilita One=Lilita One;
Limelight=Limelight;
Linden Hill=Linden Hill;
Lobster=Lobster;
Lobster Two=Lobster Two;
Londrina Outline=Londrina Outline;
Londrina Shadow=Londrina Shadow;
Londrina Sketch=Londrina Sketch;
Londrina Solid=Londrina Solid;
Lora=Lora;
Love Ya Like A Sister=Love Ya Like A Sister;
Loved by the King=Loved by the King;
Lovers Quarrel=Lovers Quarrel;
Luckiest Guy=Luckiest Guy;
Lusitana=Lusitana;
Lustria=Lustria;
Macondo=Macondo;
Macondo Swash Caps=Macondo Swash Caps;
Magra=Magra;
Maiden Orange=Maiden Orange;
Mako=Mako;
Marcellus=Marcellus;
Marcellus SC=Marcellus SC;
Marck Script=Marck Script;
Marko One=Marko One;
Marmelad=Marmelad;
Marvel=Marvel;
Mate=Mate;
Mate SC=Mate SC;
Maven Pro=Maven Pro;
McLaren=McLaren;
Meddon=Meddon;
MedievalSharp=MedievalSharp;
Medula One=Medula One;
Megrim=Megrim;
Meie Script=Meie Script;
Merienda One=Merienda One;
Merriweather=Merriweather;
Merriweather: 700=Merriweather Bold;
Metal=Metal;
Metal Mania=Metal Mania;
Metamorphous=Metamorphous;
Metrophobic=Metrophobic;
Michroma=Michroma;
Miltonian=Miltonian;
Miltonian Tattoo=Miltonian Tattoo;
Miniver=Miniver;
Miss Fajardose=Miss Fajardose;
Modern Antiqua=Modern Antiqua;
Molengo=Molengo;
Monofett=Monofett;
Monoton=Monoton;
Monsieur La Doulaise=Monsieur La Doulaise;
Montaga=Montaga;
Montez=Montez;
Montserrat=Montserrat;
Montserrat Alternates=Montserrat Alternates;
Montserrat Subrayada=Montserrat Subrayada;
Moul=Moul;
Moulpali=Moulpali;
Mountains of Christmas=Mountains of Christmas;
Mr Bedfort=Mr Bedfort;
Mr Dafoe=Mr Dafoe;
Mr De Haviland=Mr De Haviland;
Mrs Saint Delafield=Mrs Saint Delafield;
Mrs Sheppards=Mrs Sheppards;
Muli=Muli;
Mystery Quest=Mystery Quest;
Neucha=Neucha;
Neuton=Neuton;
News Cycle=News Cycle;
Niconne=Niconne;
Nixie One=Nixie One;
Nobile=Nobile;
Nokora=Nokora;
Norican=Norican;
Nosifer=Nosifer;
Nothing You Could Do=Nothing You Could Do;
Noticia Text=Noticia Text;
Nova Cut=Nova Cut;
Nova Flat=Nova Flat;
Nova Mono=Nova Mono;
Nova Oval=Nova Oval;
Nova Round=Nova Round;
Nova Script=Nova Script;
Nova Slim=Nova Slim;
Nova Square=Nova Square;
Numans=Numans;
Nunito=Nunito;
Odor Mean Chey=Odor Mean Chey;
Offside=Offside;
Old Standard TT=Old Standard TT;
Oldenburg=Oldenburg;
Oleo Script=Oleo Script;
Open Sans:400,600=Open Sans;
Oranienbaum=Oranienbaum;
Orbitron=Orbitron;
Oregano=Oregano;
Orienta=Orienta;
Original Surfer=Original Surfer;
Oswald=Oswald;
Over the Rainbow=Over the Rainbow;
Overlock=Overlock;
Overlock SC=Overlock SC;
Ovo=Ovo;
Oxygen=Oxygen;
Oxygen Mono=Oxygen Mono;
PT Mono=PT Mono;
PT Sans=PT Sans;
PT Sans Caption=PT Sans Caption;
PT Sans Narrow=PT Sans Narrow;
PT Serif=PT Serif;
PT Serif Caption=PT Serif Caption;
Pacifico=Pacifico;
Paprika=Paprika;
Parisienne=Parisienne;
Passero One=Passero One;
Passion One=Passion One;
Patrick Hand=Patrick Hand;
Patua One=Patua One;
Paytone One=Paytone One;
Peralta=Peralta;
Permanent Marker=Permanent Marker;
Petit Formal Script=Petit Formal Script;
Petrona=Petrona;
Philosopher=Philosopher;
Piedra=Piedra;
Pinyon Script=Pinyon Script;
Plaster=Plaster;
Play=Play;
Playball=Playball;
Playfair Display=Playfair Display;
Playfair Display SC=Playfair Display SC;
Podkova=Podkova;
Poiret One=Poiret One;
Poller One=Poller One;
Poly=Poly;
Pompiere=Pompiere;
Pontano Sans=Pontano Sans;
Port Lligat Sans=Port Lligat Sans;
Port Lligat Slab=Port Lligat Slab;
Prata=Prata;
Preahvihear=Preahvihear;
Press Start 2 P=Press Start 2 P;
Princess Sofia=Princess Sofia;
Prociono=Prociono;
Prosto One=Prosto One;
Puritan=Puritan;
Quando=Quando;
Quantico=Quantico;
Quattrocento=Quattrocento;
Quattrocento Sans=Quattrocento Sans;
Questrial=Questrial;
Quicksand=Quicksand;
Qwigley=Qwigley;
Racing Sans One=Racing Sans One;
Radley=Radley;
Radley: 400 italic=Radley Italic;
Raleway=Raleway;
Raleway Dots=Raleway Dots;
Rammetto One=Rammetto One;
Ranchers=Ranchers;
Rancho=Rancho;
Rationale=Rationale;
Redressed=Redressed;
Reenie Beanie=Reenie Beanie;
Revalia=Revalia;
Ribeye=Ribeye;
Ribeye Marrow=Ribeye Marrow;
Righteous=Righteous;
Rochester=Rochester;
Rock Salt=Rock Salt;
Rokkitt=Rokkitt;
Romanesco=Romanesco;
Ropa Sans=Ropa Sans;
Rosario=Rosario;
Rosarivo=Rosarivo;
Rouge Script=Rouge Script;
Ruda=Ruda;
Ruge Boogie=Ruge Boogie;
Ruluko=Ruluko;
Ruslan Display=Ruslan Display;
Russo One=Russo One;
Ruthie=Ruthie;
Rye=Rye;
Sail=Sail;
Salsa=Salsa;
Sanchez=Sanchez;
Sancreek=Sancreek;
Sansita One=Sansita One;
Sarina=Sarina;
Satisfy=Satisfy;
Scada=Scada;
Schoolbell=Schoolbell;
Seaweed Script=Seaweed Script;
Sevillana=Sevillana;
Seymour One=Seymour One;
Shadows Into Light=Shadows Into Light;
Shadows Into Light Two=Shadows Into Light Two;
Shanti=Shanti;
Share=Share;
Share Tech=Share Tech;
Share Tech Mono=Share Tech Mono;
Shojumaru=Shojumaru;
Short Stack=Short Stack;
Siemreap=Siemreap;
Sigmar One=Sigmar One;
Signika=Signika;
Signika Negative=Signika Negative;
Simonetta=Simonetta;
Sirin Stencil=Sirin Stencil;
Six Caps=Six Caps;
Skranji=Skranji;
Slackey=Slackey;
Smokum=Smokum;
Smythe=Smythe;
Snippet=Snippet;
Sofadi One=Sofadi One;
Sofia=Sofia;
Sonsie One=Sonsie One;
Sorts Mill Goudy=Sorts Mill Goudy;
Source Code Pro=Source Code Pro;
Special Elite=Special Elite;
Spicy Rice=Spicy Rice;
Spinnaker=Spinnaker;
Spirax=Spirax;
Squada One=Squada One;
Stalinist One=Stalinist One;
Stardos Stencil=Stardos Stencil;
Stint Ultra Condensed=Stint Ultra Condensed;
Stint Ultra Expanded=Stint Ultra Expanded;
Stoke=Stoke;
Strait=Strait;
Sue Ellen Francisco=Sue Ellen Francisco;
Sunshiney=Sunshiney;
Supermercado One=Supermercado One;
Suwannaphum=Suwannaphum;
Swanky and Moo Moo=Swanky and Moo Moo;
Syncopate=Syncopate;
Taprom=Taprom;
Telex=Telex;
Tenor Sans=Tenor Sans;
The Girl Next Door=The Girl Next Door;
Tienne=Tienne;
Tinos=Tinos;
Titan One=Titan One;
Titillium Web:700,900=Titillium Web;
Trade Winds=Trade Winds;
Trocchi=Trocchi;
Trochut=Trochut;
Trykker=Trykker;
Tulpen One=Tulpen One;
Ubuntu=Ubuntu;
Ubuntu Condensed=Ubuntu Condensed;
Ubuntu Mono=Ubuntu Mono;
Ultra=Ultra;
Uncial Antiqua=Uncial Antiqua;
Underdog=Underdog;
Unica One=Unica One;
UnifrakturMaguntia=UnifrakturMaguntia;
Unkempt=Unkempt;
Unlock=Unlock;
Unna=Unna;
VT323=VT323;
Varela=Varela;
Varela Round=Varela Round;
Vast Shadow=Vast Shadow;
Vibur=Vibur;
Vidaloka=Vidaloka;
Viga=Viga;
Voces=Voces;
Volkhov=Volkhov;
Vollkorn=Vollkorn;
Voltaire=Voltaire;
Wallpoet=Wallpoet;
Walter Turncoat=Walter Turncoat;
Warnes=Warnes;
Wellfleet=Wellfleet;
Wire One=Wire One;
Yanone Kaffeesatz=Yanone Kaffeesatz;
Yellowtail=Yellowtail;
Yeseva One=Yeseva One;
Yesteryear=Yesteryear;
Zeyada=Zeyada;
Roboto Condensed=Roboto Condensed;
Roboto:400,700=Roboto;
